The Weeknd - Call Out My Name
Hayley Kiyoko - What I Need feat. Kehlani
Cardi B - Be Careful
Rich The Kid - Too Gone feat. Khalid
The Weeknd - Hurt You feat. Gesaffelstein
Tinashe - Me So Bad feat. Ty Dolla $ign & French Montana
A$AP Rocky - Bad Company feat. BlocBoy JB
Thirty Seconds To Mars - Rescue Me
Ty Dolla $ign - Pineapple feat. Gucci Mane & Quavo
Michl - Better With You
Snakehips - For the F^_^k Of It feat. Jeremih & Aminé
CHVRCHES - Never Say Die
The Weeknd - I Was Never There feat. Gesaffelstein
Sam Smith - Pray feat. Logic
Denny White - Carried Away
FRENSHIP - GOODMORNING, Goodbye
Mike WiLL Made-It, Rae Sremmurd & Big Sean - Aries (YuGo) Part 2 feat. Quavo & Pharrell
Lord Huron - When the Night is Over
Junge Junge - Catch 22 feat. Valentine
Ne-Yo, Bebe Rexha & Stefflon Don - Push Back
Mike Shinoda - Crossing A Line
Digital Farm Animals, Shaun Frank & Dragonette - Tokyo Nights
Kacey Musgraves - Velvet Elvis
Grace VanderWaal - Clearly
DJDS - No Pain feat. Khalid, Charlie Wilson & Charlotte Day Wilson
Tyler, The Creator - OKRA
Sigrid - I Don't Want To Know
Charlie Puth - Change feat. James Taylor
Zak Abel - Love Song
Gnash - the broken hearts club
James TW - Say Love
Bantu - Just a Little feat. Shungudzo
Billie Eilish - bitches broken hearts
James Bay - Us
Haux - Arrows
Preme - Hot Boy feat. Lil Wayne
Nina Nesbitt - Somebody Special (R3hab Remix)
Thutmose - Ride With Me
A Boogie Wit da Hoodie - Nonchalant feat. Alkaline
Anitta - Indecente
Tori Kelly - Help Us To Love feat. The HamilTones
MØ - Nostalgia
X Ambassadors - Don't Stay (Recorded At Spotify Studios NYC)
Lady Gaga - Your Song
DJ Esco - Code of Honor feat. Future & ScHoolboy Q
Smokepurpp & Murda Beatz - Do Not Disturb feat. Lil Yachty & Offset
Yoshi Flower - Just On Drugs
Daryl Hall & John Oates & Train - Philly Forget Me Not
THEY. - Dante's Creek (deantrbl Remix)
N.O.R.E. - Uno Más (Remix) feat. Pharrell Williams, Miguel, Wiz Khalifa, J Alvarez
Au/Ra & CamelPhat - Panic Room
Warhola - Promise
SAINt JHN - GOD BLESS THE RATCHETS
Jessie Reyez - Figures, a Reprise feat. Daniel Caesar
Reo Cragun - In Too Deep
OK MAYDAY - Good
London Richards - Ends
Harry Hudson - Love, Dad
Cassadee Pope - Take You Home
Bipolar Sunshine - Pedestal
Harrison Brome - Looking at You
Jason Aldean - High Noon Neon
Lizzo - Fitness
Lil Xan - The Man feat. $teven Cannon
TOMI - What Kind Of Love
Amen Dunes - Dracula
Launder - Keep You Close feat. Soko
Her - Wanna Be You
Bhad Bhabie - Gucci Flip Flops feat. Lil Yachty
Manchester Orchestra - No Hard Feelings
Frankie Cosmos - Apathy
Unknown Mortal Orchestra - Everyone Acts Crazy Nowadays
Ashley McBryde - Home Sweet Highway
Karol G & Shaggy - Tu Pum Pum feat. El Capitaan 7 Sekuence
Ofenbach vs. Lack Of Afro - PARTY feat. Wax and Herbal T
Natalie Prass - Sisters
R3HAB & Skytech - Hyperspace
Trill Sammy - Feel Better feat. Slim Jxmmi
The Vaccines - Out On the Street
Tiësto & MOTi - Break The House Down
The Voidz - Pyramid of BonesEmbed