Beach Bunny - "Sports"
dodie - "Party Tattoos"
Parteum - "MMXVIII"
Rich Brian - "See Me"
​surrenderdorothy - "dropeverything"
1/2
BØRNS - "God Save Our Young Blood" ft. Lana Del Rey
MADUS - "Find Another Girl"
Superorganism - "Everybody Wants to Be Famous"
The Vaccines - "I Can't Quit"
1/4
Bhad Bhabie - "Both of Em"
Charlie Puth - "If You Leave Me Now" ft. Boyz II Men
Kendrick Lamar & SZA - "All The Stars"
Oliver Tree - "Upside Down"
1/5
Justin Timberlake - "Filthy"
Liam Payne & Rita Ora - "For You"
Lucas Lucco & Pabllo Vittar - "Paraíso"
MGMT - "Hand It Over"
Rae Morris - "Push Me To My Limit"
1/7
girl in red - "say anything"
1/10
Dan + Shay - "Tequila"
Troye Sivan - "My My My!"
U.S. Girls - "Pearly Gates"
1/11
Gordo - "Learn How to Watch" ft. MadeinTYO, Mac Miller
Jorja Smith - "Let Me Down" ft. Stormzy
JPEGMAFIA - "Rainbow Six"
1/12
Ansel Elgort - "Supernova"
Katy Perry - "Hey Hey Hey"
Kali Uchis - "After the Storm" ft. Tyler, The Creator, Bootsy Collins
Owl City - "Lucid Dream"
1/19
Drake - "God's Plan"
Rae Morris - "Lower the Tone"
1/23
Car Seat Headrest - "Cute Thing"
XXXTENTACION - "Fuck Love" ft. Trippie Redd
Zedd, Maren Morris & Grey - "The Middle"
1/24
The Aces - "Fake Nice"
The Garden - "No Destination"
1/25
A$AP Rocky - "Money Bags Freestyle (Dean Blunt Meditation)"
Thirty Seconds to Mars - "Dangerous Night"
1/26
Michael Cera Palin - "Portrait of a Woman on a Couch With Cats"
TEMPOREX - "Sweet Sundae"
1/31
CHVRCHES - "Get Out"Embed